NO texture/north.xpm
SO texture/south.xpm
WE texture/west.xpm
EA texture/east.xpm
C 31,229,207
F 22,156,1

111111111111111111111111111
100000000000000000000000001
10000000000000000S000000001
100001111111111111111000001
100001              1000001
100001              1000001
100001              1000001
100001111111111111111000001
100000000000000000000000001
100000000000000000000000001
111111111111111111111111111

        1111111111111111111111111
        1000000000111000000000001
        1011000001111000000100001
        1001000000000000001 10001
111111111011000001110000000100001
100000000011000001110111110111111
11110111111111011100000010001
11110111111111011101010010001
11000000110101011100000010001
10000000000000001100000010001
10000000000000001101010010001
1100000111010101111101111000011
11111111 1110101 101111010001
11111111 1111111 111111111111
