NO texture/north.xpm
SO texture/south.xpm
WE texture/west.xpm
EA texture/east.xpm
C 31,229,207,
F 22,156,1

        1111111111111111111111111
        1000000000111000000000001
        1011000001111000000100001
        1001000000000000001 10001
111111111011000001110000000100001
100000000011000001110111110111111
11110111111111011100000010001
11110111111111011101010010001
11000000110101011100000010001
10000000000000001100000010001
10000000000000001101010010001
11000001110101011111011110N0011
11111111 1110101 101111010001
11111111 1111111 111111111111
