NO texture/north.xpm
SO texture/south.xpm
WE texture/west.xpm
EA texture/east.xpm
C 31,229,207
F 22,156,1

        1111111111111111111111111
        1000000000111000000000001
        1011000001111000000100001
        10010000000D0000001 10001
111111111011000001110000000100001
10000000001100000111011111D111111
1111D111111111D11100000010001
1111D111111111011101010010001
11000000110101011100000010001
10000000000000001100000010001
10000000000000001101010010001
11000001110101011111011110N0011
11111111 1110101 101111010001
11111 11 1111111 111111111111
